XXXXXXXXXXXXXXXXXXXXXXXXXXXXXXXXXXXXXXXXXXXXXXXXXXXXXXXXXXXXXXXXXXXXXXXXXXXXXXXX
X..............................................................................X
X..............................................................................X
X..............................................................................X
X..............................................................................X
X.......p......................................................................X
X..............................................................................X
X..............................................................................X
X....................................e.........................................X
X....................................e.........................................X
X....................................e.........................................X
X....................................e.........................................X
X....................................e.........................................X
X....................................e.........................................X
X....................................e.........................................X
X..............................................................................X
X..............................................................................X
X..............................................................................X
X..............................................................................X
X..............................................................................X
X..............................................................................X
X..............................................................................X
X..............................................................................X
XXXXXXXXXXXXXXXXXXXXXXXXXXXXXXXXXXXXXXXXXXXXXXXXXXXXXXXXXXXXXXXXXXXXXXXXXXXXXXXX